Region,Casos  totales  acumulados,Casos  nuevos  totales,Casos  nuevos  con  sintomas,Casos  nuevos  sin  sintomas*,Fallecidos,%  Total
Arica  y  Parinacota,359,8,7,1,7,1.04%
Tarapaca,615,37,31,6,1,1.79%
Antofagasta,1216,107,91,16,11,3.54%
Atacama,139,5,5,0,0,0.40%
Coquimbo,153,5,0,5,1,0.45%
Valparaiso,1123,94,79,15,24,3.27%
Metropolitana,24965,2256,1826,430,184,72.61%
O'Higgins,248,24,18,6,4,0.72%
Maule,485,19,17,2,14,1.41%
Nuble,839,13,11,2,19,2.44%
Biobio,975,33,27,6,9,2.84%
Araucania,1495,13,9,4,39,4.35%
Los  Rios,212,1,1,0,6,0.62%
Los  Lagos,628,34,21,13,11,1.83%
Aysen,8,0,0,0,0,0.02%
Magallanes,921,11,9,2,16,2.68%
Total,34381,2660,2152,508,346,100%
